111111111111111111111111111111111111111111111111111
10CP0000000000000000000000000000CCCCCCCCCCCCCCCCCC1
100000000100000000000000000000000000000000000000001
100000000000000000000000000000000000000000000000001
100000000000000000000000000000000000000000000000001
100000000000000000000000000000000000000000000000001
10000000000000000000CC00000000000000000000000000001
100000000000000000000E00000000000000000000000000001
111111111111111111111111111111111111111111111111111
