1111111
10CP001
1000001
1111111
